0000000000000
1010101012222
1100110012222
1001001102222
1001101102222
1110011012222
1011011102222
1100100012222
1110001102222
1001110012222
1110001102222
1001110012222
1110001102222
1001110012222
1110001102222
1001110012222